1111111111111111111111111
1333333333333333333333331
1311111111333331111111131
1333333333333333333333331
1311111111333331111111131
1333333333333333333333331
1311111111333331111111131
1333333333333333333333331
1333333311111111133333331
1333333333333333333333331
1333333333333333333333331
1111111000000000001111111
1111111000004000001111111
1333333333333333333333331
1333333333333333333333331
1333333311111111133333331
1333333333332333333333331
1311111111333331111111131
1333333333333333333333331
1311111111333331111111131
1333333333333333333333331
1311111111333331111111131
1333333333333333333333331
1111111111111111111111111
