1111111111111111111111111
1213333333333333333333341
1011111111113111111111101
1033333333333333333333101
1011111111113111111111101
1013333333333333333333301
1011111111113111111111101
1033333333333333333333101
1011111111113111111111101
1013333333333333333333301
1011111111113111111111101
1033333333333333333333101
1011111111113111111111101
1013333333333333333333301
1011111111113111111111101
1033333333333333333333101
1011111111113111111111101
1013333333333333333333301
1011111111113111111111101
1033333333333333333333101
1311111111113111111111111
1310303030303030303030311
1313030303030303030303011
1111111111111111111111111
