1111111111111111111111111
1233333333330333333333331
1311111111110111111111131
1313333333330333333333031
1313111111110111111113131
1313033333330333333313131
1313131111110111111313131
1313131333330333330313131
1313131311110111131313131
1313131303330333131313131
1313131313110113131313131
1313131313104003131313131
1313131313000013131313131
1313131313110113131313131
1313131313330333031313131
1313131311110111131313131
1313130333330333331313131
1313131111110111111313131
1313133333330333333303131
1313111111110111111113131
1303333333330333333333131
1311111111110111111111131
1333333333330333333333331
1111111111111111111111111
