1111111111111111111111111
1110103110101101000001121
1011101000111311111100001
1111100010000000000010111
1100001000100011110000101
1110010111000110111001101
1000100111101010110000111
1011101343333111010001001
1000001333333111110110001
1000101001010010100100101
1101001101101111000110001
1000100000110110001100111
1110111011011001100001101
1000001001010100100011101
1310131111101011000011011
1100110000111000010111011
1100001011011101100001111
1131001100110110100033101
1111010111111010001133111
1001001100100100111111001
1111013111001000111111001
1101010111110010103100111
1101000000000010001110111
1111111111111111111111111
