1111111111111111111111111
1000000000011100000000001
1011101111011101111011101
1011101111011101111011101
1000000000000000000000001
1011101101111111011011101
1011101100001000011011101
1000001111101011111000001
1111101111100011111011111
1111101100000000011011111
1111101101110111011011111
1111100001000001000011111
1111100001000001000011111
1111101101110111011011111
1111101100000000011011111
1111101111100011111011111
1000001111101011111000001
1011101100001000011011101
1011101101111111011011101
1000000000002000000000001
1011101111011101111011101
1011101111011101111011101
1000000000011100000000001
1111111111111111111111111
