1111111111111111111111111
1333333333311133333333331
1311131111311131111311131
1311131111311131111311131
1333333333333333333333331
1311131131111111311311131
1311131133331333311311131
1333331111131311111333331
1111131111133311111311111
1111131133333333311311111
1111131131113111311311111
1111133331333331333311111
1111133331333331333311111
1111131131113111311311111
1111131133333333311311111
1111131111133311111311111
1333331111131311111333331
1311131133331333311311131
1311131131111111311311131
1333333333332333333333331
1311131111311131111311131
1311131111311131111311131
1333333333311133333333331
1111111111111111111111111
